Transmission pair	House	Segment	Position	Reference allele	Variant allele	Variant reads in donor	Reference reads in donor	Total number of reads in donor	Variant reads in recipient	Reference reads in recipient	Total number of reads in recipient
1	681	1	888	T	C	257	1180	1437	283	2032	2315
1	681	1	1161	C	T	60	1209	1269	29	869	898
1	681	1	1290	C	T	71	1459	1530	42	1239	1281
1	681	1	1422	A	G	651	4580	5231	157	716	873
1	681	1	2109	G	A	344	1377	1721	602	2777	3379
1	681	1	2163	G	A	867	3325	4192	1027	4374	5401
1	681	1	2202	A	G	98	3166	3264	221	14635	14856
1	681	2	465	A	G	15	380	395	12	584	596
1	681	2	489	G	A	63	331	394	83	755	838
1	681	2	603	A	G	126	585	711	35	134	169
1	681	2	1570	G	A	237	1430	1667	330	1134	1464
1	681	2	2031	A	G	265	2082	2347	3	4948	4951
1	681	2	2076	T	C	618	2350	2968	1008	4469	5477
1	681	2	2169	A	G	376	1024	1400	1029	7398	8427
1	681	3	40	G	A	976	10356	11332	698	9794	10492
1	681	3	42	C	A	475	10494	10969	284	9764	10048
1	681	3	44	A	T	335	10430	10765	175	9615	9790
1	681	3	173	G	C	17	468	485	17	3916	3933
1	681	3	480	A	C	1380	4630	6010	658	6220	6878
1	681	3	850	T	C	147	496	643	86	438	524
1	681	3	1002	C	T	24	739	763	37	1323	1360
1	681	3	1017	A	G	162	413	575	295	994	1289
1	681	3	2143	C	T	181	1949	2130	204	2615	2819
1	681	4	4	G	A	2440	17178	19618	2520	15202	17722
1	681	4	483	T	C	1358	4493	5851	814	3135	3949
1	681	4	658	T	A	744	2830	3574	225	1064	1289
1	681	4	864	A	G	124	3928	4052	167	8222	8389
1	681	4	930	T	G	2163	7240	9403	599	3341	3940
1	681	4	1017	G	T	891	8932	9823	122	1462	1584
1	681	4	1086	G	A	309	1718	2027	3133	30228	33361
1	681	4	1590	T	C	405	6424	6829	119	2900	3019
1	681	4	1680	A	G	264	7459	7723	234	6682	6916
1	681	5	234	T	C	3486	12518	16004	3378	8923	12301
1	681	5	389	C	A	54	1595	1649	18	14356	14374
1	681	5	738	A	G	53	1667	1720	24	1553	1577
1	681	5	1248	G	A	861	2796	3657	4423	31217	35640
1	681	5	1272	T	C	215	2176	2391	2904	32834	35738
1	681	6	867	G	A	8274	23855	32129	1624	5200	6824
1	681	6	1156	A	G	475	14360	14835	254	10506	10760
1	681	6	1210	G	A	1294	15869	17163	60	9796	9856
1	681	6	1276	C	T	695	21744	22439	234	11852	12086
1	681	6	1398	C	T	576	4998	5574	11	19354	19365
1	681	7	183	C	A	1901	5685	7586	2173	10119	12292
1	681	7	306	G	A	247	7574	7821	176	9991	10167
1	681	7	492	G	A	2233	8291	10524	2438	16480	18918
1	681	7	600	G	A	5937	30511	36448	6455	57181	63636
1	681	7	913	G	A	3164	11571	14735	2032	13809	15841
1	681	7	975	T	G	1797	31035	32832	2131	82894	85025
1	681	8	367	A	G	10224	49187	59411	1142	12055	13197
2	684	1	1002	C	T	130	2073	2203	4	2691	2695
2	684	1	1161	C	T	366	5359	5725	100	2710	2810
2	684	1	1290	C	T	556	10152	10708	119	2783	2902
2	684	2	447	C	T	25	648	673	9	487	496
2	684	2	603	G	A	30	785	815	10	600	610
2	684	2	1398	T	C	114	544	658	208	674	882
2	684	3	40	G	A	125	1422	1547	400	5463	5863
2	684	3	890	A	T	31	833	864	4	1221	1225
2	684	3	893	A	G	38	882	920	26	1223	1249
2	684	3	1002	C	T	107	2797	2904	25	1391	1416
2	684	3	2143	T	C	580	3430	4010	206	1366	1572
2	684	4	185	G	A	327	4571	4898	6	5798	5804
2	684	4	930	G	T	569	16972	17541	257	8270	8527
2	684	4	996	T	C	895	3485	4380	3701	16549	20250
2	684	4	1017	T	G	832	6093	6925	4810	35995	40805
2	684	4	1176	C	T	1249	5773	7022	945	3375	4320
2	684	4	1455	C	T	555	8373	8928	1	5911	5912
2	684	4	1473	A	G	1626	4809	6435	1485	4796	6281
2	684	4	1563	G	A	809	18614	19423	61	3844	3905
2	684	4	1590	T	C	1148	18808	19956	232	4065	4297
2	684	5	234	C	T	3327	94604	97931	958	22837	23795
2	684	6	1289	T	G	4069	18583	22652	2453	13765	16218
2	684	7	492	A	G	393	12600	12993	433	15867	16300
2	684	7	975	T	G	2813	65131	67944	2006	52673	54679
2	684	8	39	T	C	2263	58830	61093	2832	70079	72911
2	684	8	367	G	A	673	9801	10474	231	6679	6910
3	712	1	888	C	T	26	702	728	17	516	533
3	712	1	1014	C	A	411	972	1383	180	859	1039
3	712	1	1161	C	T	49	893	942	39	844	883
3	712	1	1290	C	T	69	1538	1607	38	854	892
3	712	2	603	G	A	9	255	264	3	167	170
3	712	2	1383	A	G	35	1015	1050	16	896	912
3	712	2	2109	T	C	173	4399	4572	590	15718	16308
3	712	3	40	G	A	227	4039	4266	281	4483	4764
3	712	3	42	C	A	140	3913	4053	120	4507	4627
3	712	3	893	A	G	18	463	481	3	92	95
3	712	3	1002	C	T	307	7328	7635	10	397	407
3	712	3	2143	C	T	915	8865	9780	379	4253	4632
3	712	4	567	G	A	480	1417	1897	565	2148	2713
3	712	4	1017	G	T	265	3103	3368	422	5883	6305
3	712	4	1353	T	C	5379	9259	14638	74	11459	11533
3	712	4	1563	G	A	98	2834	2932	299	9909	10208
3	712	4	1590	T	C	203	3038	3241	725	14495	15220
3	712	4	1665	T	C	870	3179	4049	1689	6723	8412
3	712	5	234	C	T	3857	95893	99750	1346	33005	34351
3	712	5	1251	C	T	1354	4266	5620	2030	8867	10897
3	712	7	306	G	A	182	5815	5997	224	8265	8489
3	712	7	492	A	G	708	18413	19121	501	14770	15271
3	712	7	975	T	G	1975	36776	38751	3582	88084	91666
3	712	8	39	T	C	1024	20828	21852	3231	93068	96299
3	712	8	231	C	T	2085	8152	10237	15287	70235	85522
3	712	8	367	G	A	461	8707	9168	668	12385	13053
4	742	1	320	A	G	131	468	599	688	3361	4049
4	742	1	474	G	A	20	189	209	1	1223	1224
4	742	1	888	C	T	4	101	105	6	384	390
4	742	1	1161	T	C	26	111	137	31	198	229
4	742	1	1290	T	C	118	489	607	87	413	500
4	742	1	1651	C	A	13	363	376	0	92	92
4	742	1	2202	G	A	9270	82799	92069	9858	38776	48634
4	742	2	465	G	A	19	172	191	11	37	48
4	742	2	522	G	A	8	137	145	0	32	32
4	742	2	523	A	T	8	137	145	0	32	32
4	742	2	529	G	T	8	127	135	0	32	32
4	742	2	531	G	C	8	86	94	0	40	40
4	742	2	533	G	A	11	71	82	12	33	45
4	742	2	598	A	G	5	24	29	7	47	54
4	742	2	603	G	A	2	26	28	5	47	52
4	742	2	1711	A	G	229	1892	2121	1	82	83
4	742	3	40	A	G	254	2022	2276	88	403	491
4	742	3	893	A	G	1	19	20	13	172	185
4	742	3	1002	C	T	1	22	23	11	312	323
4	742	3	2143	T	C	124	796	920	113	542	655
4	742	4	1017	T	G	190	1148	1338	193	1163	1356
4	742	4	1563	G	A	42	1326	1368	45	1275	1320
4	742	4	1590	C	T	278	894	1172	427	1112	1539
4	742	4	1680	A	G	19	540	559	109	3319	3428
4	742	5	132	T	C	683	2849	3532	475	1118	1593
4	742	5	205	T	C	81	2403	2484	30	9981	10011
4	742	5	234	C	T	132	3656	3788	367	10516	10883
4	742	6	990	T	C	27	763	790	52	2848	2900
4	742	6	1156	G	A	182	921	1103	2807	11166	13973
4	742	6	1276	T	C	1112	4807	5919	2032	8240	10272
4	742	7	521	G	A	961	7779	8740	3	4726	4729
4	742	7	975	T	G	1438	40175	41613	2162	60286	62448
4	742	8	39	C	T	6358	44563	50921	9309	64042	73351
4	742	8	367	G	A	304	6766	7070	371	7383	7754
5	751	1	888	C	T	19	443	462	272	6742	7014
5	751	1	1161	T	C	79	397	476	1395	6671	8066
5	751	1	1290	T	C	181	890	1071	1490	5236	6726
5	751	1	2079	A	G	354	9483	9837	227	5913	6140
5	751	1	2123	T	C	403	12393	12796	34	5901	5935
5	751	2	405	A	G	62	843	905	13	2246	2259
5	751	2	993	A	G	56	188	244	195	700	895
5	751	2	1383	G	A	27	129	156	479	1665	2144
5	751	2	1941	T	A	218	1090	1308	917	3771	4688
5	751	2	2109	C	T	1151	3593	4744	959	2426	3385
5	751	3	40	G	A	407	9736	10143	874	9328	10202
5	751	3	674	A	G	178	878	1056	2718	10856	13574
5	751	3	1002	T	C	83	242	325	750	1965	2715
5	751	3	1119	C	T	410	1381	1791	3249	11179	14428
5	751	3	1923	G	A	403	9275	9678	528	20644	21172
5	751	3	2143	T	C	2832	18110	20942	1133	5139	6272
5	751	4	864	G	A	1738	4801	6539	11793	32025	43818
5	751	4	930	G	T	277	8263	8540	394	9614	10008
5	751	4	1017	T	G	672	3385	4057	3737	19882	23619
5	751	4	1226	C	T	59	1870	1929	68	8320	8388
5	751	4	1563	A	G	1455	3496	4951	3811	7847	11658
5	751	4	1590	T	C	287	4744	5031	757	13918	14675
5	751	4	1665	C	T	297	8515	8812	260	9219	9479
5	751	5	234	C	T	994	26538	27532	3571	85758	89329
5	751	6	941	T	A	297	6133	6430	36	49627	49663
5	751	6	1276	C	T	496	15609	16105	1029	36345	37374
5	751	7	306	A	G	551	2626	3177	8925	36367	45292
5	751	7	975	T	G	3379	75461	78840	1143	26947	28090
5	751	8	39	T	C	1446	31791	33237	3583	83342	86925
5	751	8	367	G	A	241	5300	5541	1274	24943	26217
5	751	8	457	G	T	279	7455	7734	1682	77590	79272
6	751	1	888	C	T	19	443	462	8	157	165
6	751	1	1161	T	C	79	397	476	13	63	76
6	751	1	1290	T	C	181	890	1071	36	202	238
6	751	1	2079	A	G	354	9483	9837	146	6765	6911
6	751	1	2123	T	C	403	12393	12796	894	8976	9870
6	751	2	405	A	G	62	843	905	7	462	469
6	751	2	993	A	G	56	188	244	26	108	134
6	751	2	1383	G	A	27	129	156	388	1213	1601
6	751	2	1941	T	A	218	1090	1308	605	2289	2894
6	751	2	2109	C	T	1151	3593	4744	1273	6080	7353
6	751	3	40	G	A	407	9736	10143	97	2410	2507
6	751	3	674	A	G	178	878	1056	133	806	939
6	751	3	1002	T	C	83	242	325	130	340	470
6	751	3	1119	C	T	410	1381	1791	319	4133	4452
6	751	3	1923	G	A	403	9275	9678	235	12859	13094
6	751	3	2143	T	C	2832	18110	20942	213	1521	1734
6	751	4	864	G	A	1738	4801	6539	542	1488	2030
6	751	4	930	G	T	277	8263	8540	17	689	706
6	751	4	1017	T	G	672	3385	4057	949	6584	7533
6	751	4	1226	C	T	59	1870	1929	0	250	250
6	751	4	1563	A	G	1455	3496	4951	77	223	300
6	751	4	1590	T	C	287	4744	5031	14	404	418
6	751	4	1665	C	T	297	8515	8812	13	639	652
6	751	5	234	C	T	994	26538	27532	164	4123	4287
6	751	6	941	T	A	297	6133	6430	1	441	442
6	751	6	1276	C	T	496	15609	16105	18	1049	1067
6	751	7	306	A	G	551	2626	3177	2227	13680	15907
6	751	7	975	T	G	3379	75461	78840	556	18843	19399
6	751	8	39	T	C	1446	31791	33237	1062	29260	30322
6	751	8	367	G	A	241	5300	5541	510	10228	10738
6	751	8	457	G	T	279	7455	7734	46	5169	5215
7	751	1	888	C	T	19	443	462	62	1429	1491
7	751	1	1161	T	C	79	397	476	154	1117	1271
7	751	1	1290	T	C	181	890	1071	187	1103	1290
7	751	1	2079	A	G	354	9483	9837	18	305	323
7	751	1	2123	T	C	403	12393	12796	2	353	355
7	751	2	405	A	G	62	843	905	47	12247	12294
7	751	2	993	A	G	56	188	244	221	1629	1850
7	751	2	1383	G	A	27	129	156	293	1492	1785
7	751	2	1941	T	A	218	1090	1308	762	3547	4309
7	751	2	2109	C	T	1151	3593	4744	686	2655	3341
7	751	3	40	G	A	407	9736	10143	130	1828	1958
7	751	3	674	A	G	178	878	1056	410	2164	2574
7	751	3	1002	T	C	83	242	325	194	654	848
7	751	3	1119	C	T	410	1381	1791	462	2233	2695
7	751	3	1923	G	A	403	9275	9678	222	11636	11858
7	751	3	2143	T	C	2832	18110	20942	617	4421	5038
7	751	4	864	G	A	1738	4801	6539	1622	4541	6163
7	751	4	930	G	T	277	8263	8540	133	6371	6504
7	751	4	1017	T	G	672	3385	4057	685	4740	5425
7	751	4	1226	C	T	59	1870	1929	4	1260	1264
7	751	4	1563	A	G	1455	3496	4951	880	2069	2949
7	751	4	1590	T	C	287	4744	5031	181	3074	3255
7	751	4	1665	C	T	297	8515	8812	126	8769	8895
7	751	5	234	C	T	994	26538	27532	864	24979	25843
7	751	6	941	T	A	297	6133	6430	2	6619	6621
7	751	6	1276	C	T	496	15609	16105	118	4481	4599
7	751	7	306	A	G	551	2626	3177	4330	27480	31810
7	751	7	975	T	G	3379	75461	78840	3124	67922	71046
7	751	8	39	T	C	1446	31791	33237	2475	82935	85410
7	751	8	367	G	A	241	5300	5541	1301	26701	28002
7	751	8	457	G	T	279	7455	7734	457	18494	18951
8	779	1	225	T	A	1769	7554	9323	3400	17024	20424
8	779	1	888	T	C	242	1185	1427	1056	4157	5213
8	779	1	1161	C	T	29	893	922	195	5617	5812
8	779	1	1290	C	T	46	924	970	163	3998	4161
8	779	1	2163	G	A	3354	14913	18267	3809	15180	18989
8	779	2	489	G	A	100	665	765	282	2402	2684
8	779	2	603	A	G	60	534	594	91	657	748
8	779	2	1926	T	G	112	1896	2008	1	3357	3358
8	779	2	2076	T	C	476	1627	2103	277	1127	1404
8	779	2	2109	T	C	124	3983	4107	54	2555	2609
8	779	3	40	G	A	623	7766	8389	160	2026	2186
8	779	3	42	C	A	248	7915	8163	49	2068	2117
8	779	3	2143	C	T	282	3179	3461	111	2179	2290
8	779	4	4	G	A	2592	17546	20138	3432	19997	23429
8	779	4	198	A	G	1410	11465	12875	8	3702	3710
8	779	4	658	T	A	281	1852	2133	662	3179	3841
8	779	4	930	T	G	2729	10361	13090	1034	5794	6828
8	779	4	1017	G	T	1120	17178	18298	832	10126	10958
8	779	4	1086	G	A	2183	19348	21531	1025	8477	9502
8	779	4	1563	G	A	390	9910	10300	134	6904	7038
8	779	4	1590	T	C	547	9767	10314	648	10037	10685
8	779	4	1680	A	G	106	2662	2768	68	3674	3742
8	779	5	234	T	C	4292	14851	19143	18008	66749	84757
8	779	5	1248	G	A	786	2828	3614	2762	12238	15000
8	779	5	1272	T	C	409	1703	2112	2608	10411	13019
8	779	6	694	G	A	1308	35057	36365	1951	14911	16862
8	779	7	492	G	A	2122	13970	16092	1464	6422	7886
8	779	7	600	G	A	4923	43175	48098	3523	29589	33112
8	779	7	975	T	G	2600	67810	70410	1930	32827	34757
8	779	8	367	A	G	5104	39005	44109	1364	14068	15432
8	779	8	632	A	G	3702	26609	30311	4615	18465	23080
9	779	1	225	T	A	1769	7554	9323	653	2069	2722
9	779	1	888	T	C	242	1185	1427	611	3225	3836
9	779	1	1161	C	T	29	893	922	90	2501	2591
9	779	1	1290	C	T	46	924	970	91	1816	1907
9	779	1	2163	G	A	3354	14913	18267	501	1910	2411
9	779	2	489	G	A	100	665	765	77	532	609
9	779	2	603	A	G	60	534	594	44	332	376
9	779	2	1926	T	G	112	1896	2008	0	5338	5338
9	779	2	2076	T	C	476	1627	2103	627	2402	3029
9	779	2	2109	T	C	124	3983	4107	154	6275	6429
9	779	3	40	G	A	623	7766	8389	186	2089	2275
9	779	3	42	C	A	248	7915	8163	83	2048	2131
9	779	3	2143	C	T	282	3179	3461	32	307	339
9	779	4	4	G	A	2592	17546	20138	1789	10392	12181
9	779	4	198	A	G	1410	11465	12875	27	13166	13193
9	779	4	658	T	A	281	1852	2133	302	2205	2507
9	779	4	930	T	G	2729	10361	13090	654	3055	3709
9	779	4	1017	G	T	1120	17178	18298	411	6174	6585
9	779	4	1086	G	A	2183	19348	21531	916	6417	7333
9	779	4	1563	G	A	390	9910	10300	65	1562	1627
9	779	4	1590	T	C	547	9767	10314	159	3865	4024
9	779	4	1680	A	G	106	2662	2768	48	1345	1393
9	779	5	234	T	C	4292	14851	19143	4111	13742	17853
9	779	5	1248	G	A	786	2828	3614	298	1159	1457
9	779	5	1272	T	C	409	1703	2112	315	1393	1708
9	779	6	694	G	A	1308	35057	36365	53	22351	22404
9	779	7	492	G	A	2122	13970	16092	777	3243	4020
9	779	7	600	G	A	4923	43175	48098	9451	51645	61096
9	779	7	975	T	G	2600	67810	70410	2471	78010	80481
9	779	8	367	A	G	5104	39005	44109	1672	11822	13494
9	779	8	632	A	G	3702	26609	30311	5151	24040	29191
